src/bookmarks.md	これはタイトルです
src/how_to_concat_string_on_golang.md	Go 言語で文字列を結合する
src/how_to_git_diff.md	Blog template
src/how_to_make_web_api_on_golang.md	Go 言語でAPIサーバを作るためのインデックス
src/introduction_kafka.md	Apache kafka ことはじめ
src/introduction_readme.md	README のテンプレを考える
src/introduction_spring.md	俺のための Spring 入門かつ再整理
src/introduction_storybook.md	ぼくのための Storybook 入門
src/introduction_systemd_unit_file.md	Systemd のユニットファイルを書こう!!
src/introduction_yacc.md	これはタイトルです
src/making_command_line_tools.md	コマンドラインツールの作り方
src/making_node_module.md	はじめての npm パッケージ
src/making_vue_credit_card_form.md	Making クレジットカードフォーム (フロントエンドのコーディング課題６選)
src/snippet_EDITOR.md	EDITOR, VISUAL を使ったプログラムの書き方
src/snippet_golang_approxidate.md	Blog template
src/snippet_golang_child_process.md	Go 言語で外部の別プロセスを立ち上げる
src/snippet_golang_command_line_tool.md	Go でコマンドラインツールを作るときのテンプレ ayasuda 版
src/snippet_golang_io.md	Blog template
src/snippet_golang_mock.md	Blog template
src/snippet_golang_string.md	Blog template
src/snippet_golang_string_split.md	文字列を分割する
src/template.md	Blog template
src/the_diary_of_memme.md	のびなやみエンジニアの個人 Web サービス開発日誌。
src/tips_arguments.md	プログラムの引数に関する考え方 (コマンドライン引数・環境変数・設定ファイルの優先順位)
src/vim_completion.md	vim の補完
src/what_is_interface_at_go.md	Blog template
src/what_is_language_server.md	Language Server 事始め
src/what_is_process.md	Blog template
src/what_is_spring_context.md	これはタイトルです
src/what_is_standard_input_output.md	標準ストリームことはじめ
src/what_is_string_at_go.md	Go 言語における文字列
src/zsh_history.md	zsh history
